##########################################################################
################################################################         #
                       #####                                     ####### #
############# ######## ##### ################################### ####### #
############# ######## ####  ################################### ####### #
############# ######## ####  ################################### ####### #
###           ########                                         # ####### #
### ######### ########### ################ ##################### ####### #
# # ######### ########### ################ ##                ### ####### #
# # ######### ########### ###### ######### ## ############## ### ####### #
# # ######### ########### ###### ######### ##              # ### ####### #
# # ######### ########### ###### ######### ################# ### ####### #
# # #########          ## ######                             ### ####### #
# # ################## ## ###### ############################### ####### #
# # ################## ## ###### ##       ###################### ####### #
# #              ##### ## ###### ## ##### ###################### ####### #
# # ############ #####  #        ## #####                        ####### #
# # ############ ###### # ###### ## ######### ########################## #
# # ############ ###### # ###### ## ######### #######                    #
# # ############ ###### #        ## ######### ####### ############# ######
# # ###########  ###### ########### ######### ####### ############# ######
#   ########### ##                  ######### ####### ############# ######
# ############# ############################# ####### ############# ######
# #                                                   ############# ######
# # ############################################### ############### ######
# # ##############################    ############# ############### ######
# #                                ##               ######################
# ################################    ###############                   ##
#                                #                    #################   
##########################################################################